111111111111111111111111111111111111111111111111111111111111111111
1E0000000000000C00000C0000000000000000000000000C00000C000000000001
101001010010000010100100000001010010010100100000101001000000010101
101001001010101100100100000001010010010010101011001001000000010101
110101010101010101010101010101010101010101010101010101010101010101
1P000000C00C0000000000000000000C10000000C00C0000000000000000000C11
111111111111111111111111111111111111111111111111111111111111111111