1111111111111
100100000E0C1
1000011111101
1P0011101C101
1111111111111