1111111
1111111
11PCE11
1111111
1111111